{
  "level_id": 20,
  "name": "The Verdict",
  "grid_size": 40,
  "player_spawn": [2, 11],
  "goal_pos": [22, 12],
  "decoy_goals": [[8, 12], [14, 12], [18, 12]],
  "reverse_zones": [[7, 9, 12, 13], [15, 9, 19, 13]],
  "layout": [
    [0,0,0,0,0,0,0,0,0,0,0,0,0,0,0,0,0,0,0,0,0,0,0,0],
    [0,0,0,0,0,0,0,0,0,0,0,0,0,0,0,0,0,0,0,0,0,0,0,0],
    [0,0,0,0,0,0,0,0,0,0,0,0,0,0,0,0,0,0,0,0,0,0,0,0],
    [0,0,0,0,0,0,0,0,0,0,0,0,0,0,0,0,0,0,0,0,0,0,0,0],
    [0,0,0,0,0,0,0,0,0,0,0,0,0,0,0,0,0,0,0,0,0,0,0,0],
    [0,0,0,0,0,0,0,0,0,0,0,0,0,0,0,0,0,0,0,0,0,0,0,0],
    [0,0,0,0,0,0,0,5,0,0,5,0,0,0,5,0,0,5,0,0,0,0,0,0],
    [0,0,0,0,0,0,0,0,0,0,0,0,0,0,0,0,0,0,0,0,0,0,0,0],
    [0,0,0,0,0,6,0,0,3,0,0,0,3,0,0,0,3,0,0,6,0,0,0,0],
    [0,0,0,0,0,0,0,0,0,0,0,0,0,0,0,0,0,0,0,0,0,0,0,0],
    [0,0,0,0,0,0,0,0,0,0,0,0,0,0,0,0,0,0,0,0,0,0,0,0],
    [0,0,0,0,0,0,0,0,0,0,0,0,0,0,0,0,0,0,0,0,0,0,0,0],
    [0,0,0,3,0,0,3,0,0,3,0,0,3,0,0,3,0,0,3,0,0,0,0,0],
    [1,1,1,1,4,1,1,4,1,1,1,4,1,1,1,1,4,1,1,1,1,1,1,1]
  ]
}
